11111111111111111111111111
1P101E11111C11111111111111
10101011111C11111111111111
10000000000000000000000001
11111111111111111111111111
