1111111111111111111111111111111111111111111111111111111111111111111111111111
1000000000P00000000000000000000000000000000000000000000000000000000000000001
1001111111111111111111111111111111111111111111111111111111111111111111111111
100000000000000000000C000000000000000000000000000000000000000000000000000001
1000000000000000000000000000000000000000000000000000000000000000000000000001
1001111111111111111111111111111111111111111111111111111111111111111111111111
1000000000000000000000000000000000000000000000000000000000000000000000000001
100C000000000000000000000000000000000000000000000000000000000000000000000001
1000000000000000000000000000000000000000000000000000000000000000000000000001
1001111111111111111111111111111111111111111111111111111111111111111111111111
1000000000000000000000000000000000000000000000000000000000000000000000000001
1000000000000000000000000000000000000000000000000000000000000000000000000001
1001111111111111111111111111111111111111111111111111111111111111111111111101
10000000000000000000000000000000000000000000000000000000000000000000000001E1
10000000000000000000000000000000000000000000000000000000000000000000000001C1
1111111111111111111111111111111111111111111111111111111111111111111111111111